11111
100P1
10C01
10E01
11111
