11111111111
10C001000P1
10000100001
10E000000C1
11111111111