11111111111
10C000001P1
10000100101
10E00000101
11111111111