111111111111111
1C00010000000P1
101001000111111
101001000110C01
101101110010001
101C01000010001
101101011000001
10E100011C00001
111111111111111