11111111111
1C1001000P1
11100100001
10E00000001
11111111111