11111111111
1C000100001
11100100001
10E00000001
11111111111
