11111
10000P1
10C0001
10E0001
1111111
