11111111111
10C000000P1
10000100001
10E00000001
11111111111